111111111111111
111C0000C0000C1
11110111111P001
100001111110001
1101111E1111111
1000C0000C000C1
111111111111111