1111111111111
111111V111111
1111110111111
1001000000hC1
1000011111001
1P0011E000H01
1111110C11111
1111110111111
1111110111111
1111111111111