1111111111111
1111110111111
1111110111111
10V1000000HC1
1H00011111001
1P0011E000H01
1111110C11111
1111110111111
1111110111111
1111111111111