1111111111111
1111110111111
1111110111111
1001000000HC1
1000011110001
1P0011E000H01
1111110C11111
1111110111111
1111110111111
1111111111111