1111111111111
1111110111111
1111110111111
1E01000000hC1
1000011111001
1P00110000H01
1111110C11111
1111110111111
1111110111111
1111111111111