111111111111111
1E1C0000C000hC1
101000C0000P001
1000H0111111111
101111C00000001
100001111111101
1V01v0v0v0v0vC1
111111111111111