11111111
111E0011
1C00H0C1
10111111
10111V11
10111011
101110C1
10000001
10111001
1C1110P1
11111111