111111111
1C00000E1
100000001
1000000C1
110111011
100C10001
1P001C001
111111111