111111111111
1V0C111C00E1
101111100111
100000000111
101111101111
10000P1000C1
1111111v0001
111111111111