111111111111
111111E000C1
1P0111000011
100000011011
1C0111001011
1111110C10C1
111111111111